11111111111111
1P...1111...11
1....1111...11
1....1111...11
1....1111...11
1....1111...11
1....1111...11
1...........11
1...........11
1....1111...11
1....1111...11
1....1111...11
1....1111.G.11
1....1111...11
11111111111111