11111111111111111
1........1111..11
1...111111111..11
1........1111..11
1...P..........11
1....111111111111
1.1............11
1.11111111111..11
1.1............11
1.1............11
1.1....1111..1111
1.1....1111..1111
1.1....1111.G1111
1.1....1111..1111
11111111111111111
