11111111111111
1......1111...11
1......1111...11
1......1111...11
1........1111...11
1...........11
1...........11
1.....P.....11
1...........11
1...........11
1....1111...11
1....1111...11
1....1111.G.11
1....1111...11
11111111111111
